空空空空墙墙墙墙墙空空空空空空空空空空
空空空空墙空空空墙空空空空空空空空空空
空空空空墙箱空空墙空空空空空空空空空空
空空墙墙墙空空箱墙墙空空空空空空空空空
空空墙空空箱空箱空墙空空空空空空空空空
墙墙墙空墙空墙墙空墙空空空墙墙墙墙墙墙
墙空空空墙空墙墙空墙墙墙墙墙空空点点墙
墙空箱空空箱空空空空空人空空空空点点墙
墙墙墙墙墙空墙墙墙空墙空墙墙空空点点墙
空空空空墙空空空空空墙墙墙墙墙墙墙墙墙
空空空空墙墙墙墙墙墙墙空空空空空空空空
