######__###_
#..--#_##@##
#..--###---#
#..-----$$-#
#..--#-#-$-#
#..###-#-$-#
####-$-#$--#
___#--$#-$-#
___#-$--$--#
___#--##---#
___#########