___________########
___________#--....#
############--....#
#----#--$-$---....#
#-$$$#$--$-#--....#
#--$-----$-#--....#
#-$$-#$-$-$########
#--$-#-----#_______
##-#########_______
#----#----#________
#-----$---##_______
#--$$#$$--@#_______
#----#----##_______
###########________