__####__________
__#--###########
__#----$---$-$-#
__#-$#-$-#--$--#
__#--$-$--#----#
###-$#-#--####-#
#@#$-$-$--##---#
#----$-#$#---#-#
#---$----$-$-$-#
#####--#########
__#------#______
__#------#______
__#......#______
__#......#______
__#......#______
__########______