####____
#--#____
#-@#####
#-$-$--#
#-.-.--#
###-####
__#---##
__#$#.-#
###-#$-#
#-.-#.-#
#----$-#
#--##--#
#--#####
####____