#########
#---#---#
#-#-#---#
#-.$..$##
#--$..$-#
###$#@#-#
_#-$.---#
_#---####
_#####___