__######
__#----#
###$$$-#
#@-$..-#
#-$...##
####--#_
___####_